111111111111
100000000131
100011100101
100010001101
101111100001
120000000001
111111111111